11111111
1000E011
10P00001
10000001
10000001
11111111