11111111
10E00001
10P00001
10000001
10000001
11111111