11111111
10010110
10P1E101
10000001
1000C001
11111111