111111111111111111
1000E0000010000001
10000000111C000001
1P0000000001110001
111111111111111111