1111111111111
1E0100C000001
1000011111001
1P00110000001
1111111111111