111111
1000E1
10P001
100001
1000C1
111111